NO ./imgs/no_redbrick.xpm
SO ./imgs/so_redbrick.xpm
WE ./imgs/we_redbrick.xpm
EA ./imgs/ea_redbrick.xpm
F 122,122,122
C 255,200,160

111111111111111111111111
100000000000000001111111
10N110000000000000011111
100010011111111110001111
10000001        10000001
10111001        10111001
10001001        10000001
10001001        10000001
100010011111111110000111
100000000000000000001111
111111111111111111111111
