NO ./imgs/box.xpm
SO ./imgs/box_so.xpm
WE ./imgs/box_we.xpm
EA ./imgs/box_ea.xpm
F 65,49,27
C 123,163,189

111111111111111111111111111111111111111111111111
101001011010100101001010001001011010100101001011
10S000101010010110100101001000101010010110100101
101010000010110100100101101010000010110100100101
101001011010010010101101001001011010010010101101
101010010010100100100101101010010010100100100101
101100111010010110101000101010010010100100100101
101001011010100101001010001001011010100101001011
100000101010010110100101001000101010010110100101
101010000010110100100101101010000010110100100101
101001011010010010101101001001011010010010101101
101010010010100100100101101010010010100100100101
101100111010010110101000101010010010100100100101
111111111111111111111111111111111111111111111111