NO ./imgs/city.xpm
SO ./imgs/city.xpm
WE ./imgs/city.xpm
EA ./imgs/city.xpm
F 57,63,118
C 129,118,158

1111111111111111111111
1100000000000011000011
110000000000001100W011
1100001100000011000011
1100001100000011000011
1100001100000011000011
1100001100000011000011
1100001100000011000011
1100001100000011000011
1100001100000000000011
1111111111111111111111
