NO ./imgs/donuts.xpm
SO ./imgs/donuts.xpm
WE ./imgs/donuts.xpm
EA ./imgs/donuts.xpm
F 178,102,14
C 252,99,179

        1111111111
     111111111111111
   1110000000000000111
  110000000S000000001111
 110000111111111110000111
1100001111       110000011
100000111        110000011
100000111        110000011
100000111        110000011
11110000111111111110000111
  11100000000000000001111
   11110000000000000111
     11111111111111111
        1111111111
