NO ./imgs/back2.xpm
SO ./imgs/back2.xpm
WE ./imgs/back2.xpm
EA ./imgs/back2.xpm
F 30,51,64
C 156,172,182

111111111111111111111111
100011001010100001001001
10S000101010010100100101
101010000000110100100001
101001011010010010101101
101010010010100100000101
101100111010000110101001
111111111111111111111111
