NO ./imgs/forest.xpm
SO ./imgs/forest.xpm
WE ./imgs/forest.xpm
EA ./imgs/forest.xpm
F 65,49,27
C 46,55,27

111111111111111111111111
101001011010100101001011
10S000101010010110100101
101010000010110100100101
101001011010010010101101
101010010010100100100101
101100111010010110101001
111111111111111111111111
