NO ./imgs/no_redbrick.xpm
SO ./imgs/so_redbrick.xpm
WE ./imgs/we_redbrick.xpm
EA ./imgs/ea_redbrick.xpm
F 122,122,122
C 255,200,160

   11111111
   10000001
   10S00001
   10001001
   10001001
   10001001
   10001001
   11111111
